##########
#   O ##O#
#  OXP   #
#   # X  #
# X OX   #
#        #
##########
