    #####             
    #   #             
    #X  #             
  ###  X###           
  #  X    #           
### # ### #     ######
#   # ### #######  OO#
# X  X       X     OO#
##### #### #P####  OO#
    #      ###  ######
    ########          
